WWWWWWWWWWWWWWWWWWWWWWWWWWWWWWWWWWWWWWWW
W______________________________________W
W______________________________________W
W______________________________________W
W______________________________________W
W______________________________________W
W______________________________________W
W______________________________________W
W______________________________________W
W______________________________________W
W______________________________________W
W______________________________________W
W______________________________________W
W______________________________________W
W______________________________________W
W______________________________________W
W_____________WWWW___WWWW______________W
W_____________W_________W______________W
W_____________W____P____W______________W
W_____________WWWWWWWWWWW______________W
W______________________________________W
W_________WWWWWWWWWWWWWWWWWWW__________W
W_________W____________________________W
W_________W____________________________W
W_________W____________________________W
W______________________________________W
W______________________________________W
W______________________________________W
W______________________________________W
W______________________________________W
W______________________________________W
W______________________________________W
W______________________________________W
WWWWWWWWWWWWWWWWWWWWWWWWWWWWWWWWWWWWWWWW
