WWWWWWWWWWWWWWWWWWWW
W__________________W
W_WWWWWWW_WW_WWWWW_W
W_W________W_W_____W
W_W_WWWWWW_W_W_WWW_W
W_W_WWWWWW_W_W_____W
W_______________WWWW
W_WWW_WWW_WWW_W_W__W
W_____W  P  W_W_W__W
W_WWW_WWWWWWW_W_W__W
W__________________W
W_W_W_WWWWWWW_WWWWWW
W_W_W_WWWWW________W
W_W_W_______WWWWWW_W
WWW_WWWW_WWWWWWWWW_W
W__________________W
WWWWWWWWWWWWWWWWWWWW
