WWWWWWWWW
W_______W
W____P__W
WWWWW_WWW
W___W_WWW
W___W_WWW
WWWWWWWWW
